9 11
WWWWWWWWWWW
W-E-E-E-E-W
W---------W
W-E-E-E-E-W
W---------W
W-E-E-E-E-W
W---------W
W-E-E-E-E-W
WWWWWGWWWWW
