9 11
WWWWWWWWWWW
WW-E-E-E-EW
WW--------W
WW-E-E-E-EW
WB--------W
WW-E-E-E-EW
WW--------W
WW-E-E-E-EW
WWWWGWWWWWW
